7 7 3
@ @ W @ @ . @
@ . . . . . .
. . @ . . . @
. . @ @ @ . @
. @ | . . . @
. @ @ @ @ . @
. . @ . . . .

@ . @ . @ | @
. . @ . @ . .
@ . @ . . . @
. W @ @ @ . @
. . . . @ . @
. @ @ . @ . @
. . @ . . . .

@ @ . @ @ @ @
. @ . . . . W
. . . @ . @ .
. @ . @ . @ .
@ . . . @ . .
@ $ @ . @ . @
@ @ @ . . . @

